#######
#A#R  #
#     #
#     #
#R    #
#######
