#######
#A#  R#
#     #
#A    #
#RA   #
#######
