#######
#A# #R#
#   # #
#A   A#
#RA   #
#######
